Helstar	Harsh Reality
Carpathian Forest	Dypfryst / Dette Er Mitt Helvete
Cantique Lépreux	Tourments Des Limbes Glacials
A Silver Mt. Zion	Could've Moved Mountains...
David Bowie	Fill Your Heart
Anthrax	Lone Justice
Meshuggah	Sane
The Rolling Stones	Yesterday's Papers
Аквариум	Мой друг музыкант
Нейромонах Феофан	Посевная
The Fall	O.F.Y.C. Showcase
Telex	Rock Around The Clock
Against Me!	Fuckmylife666
Kings of Convenience	Homesick
Chimaira	Power Trip
Dream Theater	Stream Of Consciousness
Pink Floyd	The Narrow Way, Part III
Chimaira	Black Heart
Black Sabbath	Cardinal Sin
bôa	Fool
Dream Theater	Illumination Theory
Bal-Sagoth	And Lo, When the Imperium Marches Against Gul-Kothoth, Then Dark Sorceries Shall Enshroud the Citadel of the Obsidian Crown
L.A. Witch	Good Guys
Mammal Hands	Kudu
Faun	Nahtegal
Disturbed	Stupify
Ultra Naté	Free
Kvelertak	Månelyst
Above & Beyond	Sticky Fingers
I Hear Sirens	The Faint Reflection Of Stars
Drake	Pound Cake / Paris Morton Music 2
Bonaparte	Computer in Love
Movements	Daylily
The Prodigy	O
K.I.Z.	Spasst
Charlie Parker	Summertime
Black Light Burns	Cruel Melody
Iron Maiden	To Tame A Land - 2015 Remaster
Radiohead	Bullet Proof ... I Wish I Was
At the Gates	Suicide Nation
Calexico	Glowing Heart of the World
John Williams	Dobby the House Elf
PandRezz	Over You
Dan Denison	Pure Desire
John Williams	The Portrait Gallery
Yo La Tengo	Pablo and Andrea
Ulcerate	Abrogation
Pain of Salvation	Reasons
Serj Tankian	Baby
Cibo Matto	Apple
Neil Young	Tell Me Why
M83	Feelings
Jai Paul	He
simon eng	oh
Hellions	Bad Way
Wu-Tang Clan	It's Yourz
Periphery	Stranger Things
Bright Eyes	Another Travelin' Song
Fleet Foxes	Heard Them Stirring
Rolling Blackouts Coastal Fever	Clean Slate
Tender	Closer Still
Daniela Andrade	Crazy In Love
Vetiver	Last Hurrah
Mad Caddies	No Hope
Mad Caddies	Villains
Long Distance Calling	Welcome Change
Farin Urlaub	Wunderbar
Yeasayer	Daughters of Cain
The Glove	Like An Animal
Dave Brubeck	Thank You
Green Carnation	The Burden is mine...Alone
Jonas Blue	Fast Car - Radio Edit
Beach House	White Moon - iTunes Session Remix
SMRTDEATH	Madman
Epic45	Sun Memory
July Skies	Waiting to Land
Stars of the Lid	Before Top Dead Center
Marconi Union	Weightless Part 2
Pyhimys	Chanelle
Haloo Helsinki!	Rakas
Akercocke	Familiar Ghosts
Magnolia Electric Co.	The Handing Down
Cattle Decapitation	Ave Exitium
The Head and the Heart	Fire/Fear
Necrophobic	Where Sinners Burn
Frank Zappa	Camarillo Brillo
The Fratellis	For The Girl
Les Sins	Bother - Morgan Geist Remix
El Michels Affair	Tearz
Heaven in Her Arms	Get Out
Head of the Demon	Zurvan's Ordeal
Boa	Blah
Charli XCX	Boys
Scarve	Irradiant
Epica	Chasing The Dragon
Widek	Comet
Amon Amarth	Coming Of The Tide
Black Veil Brides	Dead Man Walking
Stratovarius	Fireborn
As I Lay Dying	Forced To Die
Diecast	Internal Revolution
Epica	Nostalgia
Behemoth	Pan Satyros
Scar Symmetry	Reborn
Spineshank	Stain
Drowning Pool	Upside Down
Testament	Urotsukidoji
slushii	Some More
The Isley Brothers	Brother, Brother
Bill Callahan	Honeymoon Child
The Sonics	Like No Other Man
Billy May	The Look of Love
Basement Revolver	Tree Trunks
The Velvet Underground	What Goes On
Seven Sisters of Sleep	CCEC
Prurient	Frozen Niagara Falls
Bill Evans	I'll See You Again
Bill Evans	Mother of Earl
Brazzaville	Oi
Tord Gustavsen Quartet	On Every Corner
Saint Etienne	The Way We Live Now
Cat Stevens	Where Do The Children Play?
Genesis	One Day
Poliça	Spilling Lines
Library Tapes	A Summer By The Sea Ii
Alela Diane	Colorado Blue
Ryan Adams	Boys
Björk	Isobel - Family Tree Version
Zoé	Corazón Atómico
Café Tacvba	El borrego
Quicksilver Messenger Service	It's Been Too Long
Fishmans	Part 3
For BDK	Look Back To Remember This Crime
Lights Out Asia	MIR
6ix9ine	BEBE
INXS	Do Wot You Do
Phish	Fee
Tom Petty and The Heartbreakers	The Dark of the Sun
Paperclip People	Country Boy Goes Dub
Lymbyc Systym	Generated Bodies
iamamiwhoami	shadowshow
Seigmen	Hjernen Er Alene
Warrant	Down Boys
Get Well Soon	The Only Thing We Have To Fear
Rev Rev Rev	Buzzing Flowers Ecstasy
Lily Kershaw	As It Seems
Aphrodite's Child	It's Five O'Clock
Hailu Mergia	Sewnetuwa
Shintaro Sakamoto	This World Should Be More Wonderful
Beatsteaks	Soljanka
Roosevelt	Belong
Porches	By My Side
Unwound	All Souls Day
Mechina	As Embers Turn to Dust
M.I.A	Borders
Yann Tiersen	Hent III
Killswitch Engage	Until The Days
Blackout Problems	Kontrol
Sufjan Stevens	Death with Dignity - Helado Negro Remix
Beth Orton	Falling
Tindersticks	Can Our Love...
Claudia Kane	Darling Is Not My Name
The Chainsmokers	Good Intentions
The Dumplings	Technicolor Yawn
Masayoshi Fujita	Live at Frameworks, Munich 2012
Kuedo	Salt Lake Cuts
Xiu Xiu	The Wrong Thing
Kassem Mosse	Untitled A2
Enya	To Go Beyond
Ton Steine Scherben	Ich will nicht werden was mein Alter ist
Oasis	Headshrinker
The Ataris	i.o.u. One Galaxy
The Real Kids	Better Be Good
Dead In The Dirt	Burden of Life
Reagan Youth	I Hate Hate
Reverend Horton Heat	Jimbo Song
Dead Kennedys	Rawhide
The Count Bishops	Teenage Letter
Robert Gordon	The Way I Walk
Sarah Longfield	The Salient Voyage
Die Ärzte	Hair Today, Gone Tomorrow
Die Ärzte	Siegerin
Hundredth	Remain & Sustain
Dryjacket	Misused Adrenaline
Twin Peaks	My Boys
Summer Cannibals	The Lover
JGRREY	Pretty Insane
sioux falls	past tense
Christina Aguilera	F.U.S.S.
Digitalism	The Pulse
Little People	Cartouche
Airbag	Light Them All Up
Timber Timbre	Beat the Drum Slowly
The Cure	One More Time
Led Zeppelin	You Shook Me - 23/3/69 Top Gear; 2016 Remaster
Anaal Nathrakh	Procreation of the Wretched
Iron Maiden	Children Of The Damned
Lapalux	We Lost
Fetty Wap	Different Now
Nipsey Hussle	Last Time That I Checc’d
Grendel	The Judged Ones
Battle Beast	Familiar Hell
Elton John	Sails
The Flatliners	Birds Of England
Ray LaMontagne	Julia
Wallows	Scrawny
Vetiver	To Who Knows Where
We Are Scientists	You Failed
Elobrian Sunrise	When We Gather
Joseph Shabason	Face Chord
Holly Herndon	Morning Sun
John Garcia	Flower
Evile	Schizophrenia
Tom Petty	Zombie Zoo
Donovan	As I Recall It
Widowspeak	Ballad of the Golden Hour
Knuckle Puck	Evergreen
Circa Survive	Imaginary Enemy
Thank You Scientist	Prelude
Bad Rabbits	Push
Envy on the Coast	Southern Comfort
Cancer Bats	Snake Mountain
Groove Armada	I See You Baby
植松伸夫	Find Your Way
Kamferdrops	Jag trodde änglarna fanns
King Crimson	Industrial Zone B
Mc Wm	Sua Amiga Vou Pegar
Tyler, the Creator	Golden
Jitwam	Keepyourbusinesstoyourself
Wormed	57889330816.1
Brujeria	Culpan La Mujer
Hour of Penance	Mass Crucifixion of Kings
Barenaked Ladies	Alcohol
The Tragically Hip	Freak Turbulence
Meshuggah	Do Not Look Down - Live
Hank Williams	Jambalaya
Hank Williams	My Bucket's Got a Hole in It
Big Wild	6's to 9's
Makari	Dashboard
Lonnie Holley	Copying the Rock
Cate le Bon	The Light
James	Dream Thrum
Svart Crown	Living With The Enemy
Ulver	Norwegian Gothic
Wild Belle	Untamed Heart
Doom	After The Bomb
Doom	Phobia For Change
Rubén González	La Engañadora
Neal Acree	Monk
The Locust	AOTKPTA
Ameer Vann	Emmanuel
Verse	Let It All Rust
Dub Trio	Regression Line
Quicksand	Simpleton
RADWIMPS	Date
Showtek	Cannonball
Sandy Denny	It'll Take A Long Time
Mystic Braves	Coyote Blood
Thelonious Monk	Bye-Ya
Mission of Burma	Learn How
Throwing Muses	Hook In Her Head
Shawn Mendes	Memories
Nick Cave & Warren Ellis	The Proposition #2
Amon Amarth	Balls To The Wall
Jukka Nousiainen	Köyhät kyykkyyn
Mystery Jets	Flakes
David Bowie	Real Cool World
Prince	Scarlet Pussy
Jamey Johnson	In Color
Echosmith	Come With Me
Bryce Dessner	Section 2
3OH!3	CLAUSTROPHOBIA
Philanthrope	Espoir
Dirtwire	Lost Highway
Manchester Orchestra	I'd Rather Have
Crissi Cochrane	Pretty Words
Bel Canto	Dreaming Girl
Skye Sweetnam	I Don't Really Like You
Metaform	Let Your Hair Down Girl
Bikini Kill	This is not a Test
Saimaa	Ennätys
Journey	Never Walk Away
Mura Masa	Teenage Headache Dreams
The Skids	Charade
Kent	Ansgar & Evelyne
XTC	Poor Skeleton Steps Out
Motorpsycho	The Other Fool
Orbital	Walk Now...
Mark Pritchard	Rebel Angels
Eyedea & Abilities	One Twenty
War	Lonely Feelin'
Kula Shaker	Smart Dogs
PLS&TY	Feeling Forever - Bondax Remix
Sega Bodega	mimi
Four Stroke Baron	Neon Person
Scale the Summit	Origin of Species
Lunar Aurora	Beagliachda
Alter Bridge	Last Of Our Kind
Los Campesinos!	Life Is a Long Time
Closure in Moscow	Had to Put It In the Soil
Mystery	The Last Glass of Wine
P!nk	Mean
Vök	Out of the Dark
Nisse	Herz auf Beat
Debauchery	Cuntkiller
Whiplash	Respect the Dead
Forbidden	Step By Step
Seal	Human Beings
Robert Johnson	Preaching Blues
Savages	Strife
Kings Of Tomorrow	Finally
Regal	L'éternité - Charlotte De Witte Remix
Louna	Кризис крайст суперзвезда
Thylacine	Antidote
Lankum	Katie Cruel
The Knife	New Year's Eve
Imelda May	Don't Do Me No Wrong
Imelda May	Let Me Out
Atreyu	Stronger Than Me
The Piano Guys	Summer Jam
David Toop	Things Just Went Sour Gradually All At Once - Mixed
Here Lies Man	Eyes of the Law
Pantera	Drag The Waters - Remastered
Ice Cube	Real N***A Roll Call
Vorde	Blood Moon
Booker T. & The M.G.'s	Green Onions - Single/LP Version
We Have Band	Tired Of Running
Slade	Born to Be Wild
Everclear	I Will Buy You A New Life - 2004 Digital Remaster
Corderoy	Close My Eyes - Don Diablo Edit
Metalite	Apocalypse
Nothingface	Pacifier
88Rising	Swimming Pool
Rod Stewart	Merry Christmas, Baby
Caloncho	El Derroche - Crónica De Fiesta Pt.1
Thunder	Flawed To Perfection
Mike Ness	Funnel of Love
Phase Fatale	Binding By Oath
Kite	Count The Days
The Flower Kings	Romancing the City
Mouse on Mars	Tankpark
Reverend Bizarre	The Wrath of the War Elephants
CMX	Ojai
Gang of Four	I'm a Liar
Lennie Tristano	If I Had You
Zao	Resistance
Dead Fish	Descartáveis
Eisley	Shelter
Beach Slang	Bar No One
Texas Is the Reason	Nickel Wound
One Direction	Hey Angel
Ace Marino	Neon Love
DROELOE	Snow Shovels
Bilderbuch	Ich Hab Gefühle
Subsignal	Beautiful & Monstrous
Lushlife	This Ecstatic Cult
Ausmuteants	Wrong
The Acacia Strain	Dark Harvest
Millencolin	Chiquita Chaser
Chavela Vargas	Tu Me Acostumbraste
The Band	Ophelia - Concert Version
Lucinda Williams	Reason To Cry
Satellite Stories	Miracle
Hypocrisy	Departure
Profane Omen	Painbox
Ane Brun	Horizons
The Associates	Logan Time
Neneh Cherry	Money Love
That Is Good	Make It Work
Hard-Fi	Television
HOLYCHILD	Carmelo
Chai	Walking Star
John Hammond	Shore Leave
Nordmann	The King
Fonky Family	Art de rue
Saga	See Them Smile
Czesław Niemen	Jednego serca
Mikky Ekko	Not the One
Sheryl Crow	Tell Me When It’s Over
Hey Mercedes	Every Turn
Lil Uzi Vert	Ballin
Division	Act. 1
Anthem	Overload
Backtrack	Play Safe
The Wedding Present	Northern Ireland
Heisskalt	Wie Sterne
Sepultura	Murder - Remastered
Bleed The Sky	Paradigm In Entropy
Cody Simpson	Wish U Were Here - Acoustic
Nicole Zefanya	Anaheim
Chancho En Piedra	Eligiendo Una Reina
Dr. John	Mardi Gras Day
Protector	Road Rage
Half Japanese	Here We Are
Sagittarius	Musty Dusty
Calibre	Rollover
Cobrah	WET
Between the Buried and Me	Desert Of Song - 2019 Remix / Remaster
Flotsam and Jetsam	Fork Boy
Finger Eleven	Temporary Arms
Bestia Bebé	El gran Balboa
Beth Orton	Tangent
Sébastien Tellier	L'Amour Naissant II
Amanda Palmer	The Ship Song
Public Image Ltd.	Happy
Pabst	Ibuprofen
TW Walsh	Ride It Out
Red Apollo	A Sacred Kingdom Come
Max Corbacho	Islandless Expanse
Murlo	Limbo
Giacomo Puccini	Madama Butterfly / Act 2: Coro a bocca chiusa
Modern Jazz Quartet	The Golden Striker
